Appl => applicative
adpositions => adposition
Assertion => assertion
borrow => Borrowing
borrowed => Borrowing
borrowing => Borrowing
borrowing => Borrowing
compounds => compound
Compounds => compound
directionality => directional
EPP-Feature => EPP
Ergative => ergative
externalization => Externalization
extraction => Extraction
Factive => factive
Force => force
Fronting => fronting
Force => force
Gesture => gesture
islands => island
Infinitival => infinitive
Lexicon => lexicon
minimalist => Minimalist
Morphological => morphology
morphological => morphology
Participle => participle
Periphrasis => periphrasis
Person => person
Phase => phase
pragmatics => pragmatic
Presupposition => presupposition
Projection => projection
Question => question
tenses => tense
traces => trace
